NO    ./textures/hitler2.png

SO	./textures/eagle.png

WE ./textures/bricks3.png

EA textures/wood.png
   
C 254,2,2

F 0,0,0

        1111111111111111111111111
111111111011000001110000000000001
100000000011000001110111111111111
11000001110101011111011110N00111
11110111 1110101 1011110100001
11111111 1111111 111111111111