NO    ./textures/bricks.xpm

SO	./textures/enemy.xpm

WE ./textures/gold.xpm          

EA ./textures/wall.xpm     
 
F 220,100,0

C 222,2,2

11111111111111111
11111111111111111
11111111111111111
11111110111111111
11100000001111111
11100000001111111
10000000000000001
100000000000000N1
10000000000000001
11100000000001111
11100000000001111
11111111111111111