NO    ./textures/hitler2.png

SO	./textures/eagle.png

WE ./textures/bricks3.png

EA textures/wood.png
   
C 255,0,0

F 0,0,255

        1111111111111111111111111
11111111101100000000000000000001
10000000001100000111011110111111
11000001110101011111011110N00111
11110111 1110101 1011110100001
11111111 1111111 111111111111