NO    ./textures/bricks.xpm

SO              ./textures/enemy.xpm

WE ./textures/gold.xpm          

EA ./textures/wall.xpm     
 
F 220,100,0

C 222,2,2

111111111
101010101
100000001
1000W0001
100000001
100000001
111111111