NO    ./textures/bricks.xpm

SO	./textures/enemy.xpm

WE ./textures/gold.xpm          

EA ./textures/wall.xpm     
 
F 220,100,0

C 222,2,2

11111
10111
10001
1N101
11111