NO    ./textures/hitler2.png

SO	./textures/eagle.png

WE ./textures/bricks3.png

EA textures/wood.png
   
C 222,2,2

F 0,0,0


        1111111111111111111111111
        1000000000110000000000011
        1011000001110000000010001
        100100000000000000N001001
111111111011000001110000000000001
100000000011000001110111111111111
11111111111111011111111111111
11111111111111011111111111111
11110111111111011100000010001
11110111111111011101010010001
11000000110101011100000010001
10000000000000001100000000001
11111111111011111111111111111
11111111111011111111111111111
10000000000000001101010010001
110000011101010111110111100111
11110111 1110101 101111010001
11111111 1111111 111111111111