NO    ./textures/bricks.xpm

SO              ./textures/enemy.xpm

WE ./textures/gold.xpm          

EA ./textures/wall.xpm     
 
F 220,100,0

C     222,2,2

   
        1111111111111111111111111
111111110110000011100N0000000000111111111111111111
111111111111111111111111111111111111
                                  
111111111111111111111111111111111111
110000001101010111000000100011111111111
1000000000000000110000001000100010000001
1000000000000000110101001000111111111111111
1100000111010101111101111100111
1111111 1110101 101111010001 
11111111 1111111 111111111111