NO    ./textures/bricks.xpm

SO              ./textures/enemy.xpm

WE ./textures/gold.xpm          

EA ./textures/wall.xpm     
 
F 220,100,0

C 222,2,2

111111
100101
101001
1100N1
111111